
    ###
    #@##
#####$.#
#  #  *#
#  # $.#
#   $ .#
#     ##
#######
