
    ###
 ####+#
 #  ..#
##$#  #
#  $$ #
#    ##
###  #
  ####
