
#######
# .   #
# . $ #
##.#$ #
 #@ $ #
 ##  ##
  ####
