  #####
###  .#
# . $.#
#  $$$#
###$+ #
  # $##
 ##  #
 #. .#
 #####
