       ###
########.#
# .    $@#
# * $ # $#
##   ###.#
 #.# # ###
##$  #
# $ ##
# . #
#####
