
 #######
 #     #
## #   #
#.*#  ##
#. # ###
#@$$   #
#  #   #
########
