
   ######
####    #
#@ $  $ #
# # $# ##
#...   #
########
