    #######
#####  .. #
#         #
#  $.###  #
###$ ######
  #  #@#
  ## $ #
 ###$$ #
 #.  . #
 #######

