      ####
   ####+ #
   #  #$$#
####$ # .#
#     $  #
# *$ *.* #
#. .  #  #
##########
