####   ####
#  #####@.#
#    *  **##
#      $$  #
#######.$. #
      ###  #
        ####
