 ######
##  .+#
#   **##
# #.$  #
# $ $  #
###  ###
  #  #
  ####

