 #####
 # @ #
 #$#$###
## . $ #
#  .*# #
#  .   #
########
