
#####
#.. ###
# .   #
##  $ #
#@$ $ #
####  #
   ####
