  ###
  #.#
### #
#. $###
#.* $@##
#  $.$ #
#.$$#  #
# . #$ #
## .  ##
 ######
