   ######
  ##  . ####
  #@$ $ .  #
  # * # $# #
  ##* #  $ #
###  #  $###
#.   *.   .#
############
