
#########
#..##   #
#.*     #
#. ######
#  #  ###
# $$$   #
##@$    #
 ####   #
    #####
