   #########
   ###   ###
   #  $ $  #
#### .   . ####
# # #$.#.$# # #
# $    +    $ #
#   #$.#.$#   #
#### . $ . ####
    #  #  #
    #######