#####
#   ##
#    ######
#.# $##   #
##      $ #
# $ #..  ##
#@$.###  #
##  # ####
 ####
