##########
#        #
# $.$$.$ #
#  .* .  #
# @. *.  #
# $.$$.$ #
#        #
##########