
 #####
 #.  ##
##.#  #
# .  $##
#   $$ #
####@  #
   #####
