
   #####
####   #
#  $   #
#. @$$ #
#..  ###
######
