
#####
#   ####
# #.  .#
# $$ # #
#@$.   #
########
