      #####
#######   #
#         #
# $$#$#*# ###
#   #.....  #
# $$#$#.### #
#   #  @    #
#############
