  ######
  #.# .##
  #. . .#
 ##$ $$ ##
##  $#.  #
#@$$ #   #
# $. #   #
###  #####
  ####
