#####
#.  #
#.  ####
##. #@ #
 # .#$ #
 # #  $##
 # #$ $ #
##$#  # ##
#    .$  ##
#.  ## $ .#
###########
