  #########
 ##.#.  $ #
 #    # $ #
 #   ###  #
##. $ ### #
#   # ### #
#  # $ +# #
##    $#  #
 #  #     #
 ##    # .#
  #########
