
#######
#.$   #
# #$. #
#   $##
#@  .#
##  ##
 ####
