######
#   .##
# . *.#
# $$.##
### .#
 # $ #
 #   #
 ##$$##
 #@ $.#
 ######
