#########
#. . #@ #
#  *$$$*#
#     $ #
##.$###.#
 #  # ###
 ##.#
  ###
