
    ###
  ###.#
  #@ .#
###$$.#
#   $ #
#    ##
######
