
  #####
  # . #
###$. #
#   . #
# $$  #
## @###
 ####
