  ######
  #..  ###
  ### $@ #
    # $  #
  ### ####
  #.  ####
###$$    #
#  $ #$  #
#.   . . #
##########
