################
#              #
# $ $$$##$$$ $ #
###  # .  #  ###
  ## .    * ##
   ## #**# ##
    ##....##
     ##.+##
      ####
       ##
