
   ####
####@.#
#   $*#
#   # #
###   #
  #####
