
       ########
       #  #   #
       #  $   #
########  ##$##
#  #   ##$##  #
#  $   $   #  #
#  #####   #  #
##$##  ##### ##
#   $  #  #  #
#   #  #  # ##
#####$##### #
   #  #   #@#
   #  #   $.#
   #  ##$##.#
   ##$##  #.#
   #   $  #.#
   #   #  #.#
   ########.#
          #.#
          #.#
          #.#
          #.#
          #.#
          #.#
          ###
