     #####
  #### . #
  #.  ...#
###$$##  #
#    #@**#
#  $ $   #
#  #  ####
### $ #
  #   #
  #####
