### #####
#.###   #
# # * $ ##
# *  #  .#
# #$   . #
#@$  ## ##
###  $ .#
  #######
