
     ###
    ##.#
   ## .#
####  .#
#@$    #
#  $$ ##
###   #
  #####
