       ####
    ####@ #
#####   . #
#   $*$ * #
#    . ####
#####  #
    ####
