
#####
#...#
##  ###
#  $$@##
#   $  #
####   #
   #   #
   #####
