##########
#  #     #
#.$#     #
#.*.. ####
#.$## #  #
#. #  $ $##
# $#      #
#  #### # #
# $#  # # #
# @#  #   #
####  #####
