  ####
 ##. ###
## . $ #
#  .**@#
# $  $ #
#####  #
    ####
