########
#      #
# $..$ #
# .  . #
# $+$$ #
# $$.$ #
# .  . #
# $..$ #
#      #
########