 #######
  #  .  #
###.$#$ #
# . .$  #
#@#.$$*##
#      #
########

