
    ###
 ####.#
 #  ..#
## $ .#
#@$$$##
#    #
######
