####
#  #####
# $@$  ###
# $# $.  #
#   #$...#
#     $* #
#######..#
      #  #
      ####
