    #####
   ##   #
#### $  #
#  $   ##
#  @$###
###.$.####
  #    ..#
  ########
