
#######
#   ..#
#.**.$#
##@$$ #
 #$   #
 #    #
 ######
