
#######
#..*..#
# #$*.#
#   $ #
#  $$$#
#@    #
#######
