   #####
   # . ##
####    ###
#  $.$$   #
# . $#  $ #
#    ## $ #
#@  .# $###
###    .#
  # ..###
  #####
