
#####
#.. ###
# .$  #
## @$ #
 #  $ #
 ###  #
   ####
