
  #####
  #   #
  #@#*#
###$  #
#. $  #
# # #.#
#     #
#######
