 #####
 #  .####
 #   *. #
 # $ #  #
###   $.#
#   ### #
# $$#.#*##
###   $ +#
  ##   ###
   #####
