
#####
#..+#
# $$##
##$  #
#    #
#    #
######
