 ######
 #   .#
 #*$@##
##.$####
#     .#
#$.$$$ #
#  #  .#
#. #.$ #
########
