  #####
  #   #
##     ##
# #*.*# #
#   @*  #
# #$*$# #
#  *    #
# #*.*###
#########