   ######
####    #
#  #    #
#.*$  ####
#@ # $   #
#.$# $   #
#. ### $##
#. # #$.#
#.## #  #
###  #  #
     ####
