#########
#       #
# .*.*. #
# .$.$. #
#  $.$  #
# $$.$$ #
#   @   #
#########
