   ########
   #. .. .#
   # .   ##
   ##.  ##
##### $ #
# $   ###
#@$$$ ##
##   $ #
 ##    #
  ######
