   #####
   #   #
 ## . $ #
#  .#* $ #
#  . $@  #
#  .#* $ #
 ## . $ #
   #   #
   #####