
######
#.#  ##
#.$   #
#@ $$.#
###   #
  #   #
  #####
