
########
#.     #
#.#### #
#.   # #####
#.   #     #
###  ##### #
  #  #@### #
 ## $ $    #
 #  ##   # #
 # ###   # #
 #   $$# # #
 #####     #
     #######
