#####
# . #
# $ #
# @ #
#####
