      ######
####  #    #
# @#  # $  #
# #####  ###
# # $ $ ###
# $       #
##$###.#  ##
#   #      #
#   $.## ..#
#  ##.##.###
##########
