      #####
  #####.#.#
###   ....#
#  $ ## # #
#     $ # #
##    $## #
 #  # $@$ #
 ## ##$#  #
  #    ####
  ######
