########
#      # #####
#  .# $###   #
#  ### #@$ # #
#  #    $  $ #
#.    $ #### ###
#  .  ###  #   #
#     .#   # $ #
# $ #  ##### $ #
###       ## $ #
  ####    ## $ #
     ####      #
      #...   ###
      #... ###
      ######
