#######
# .* .#####
#      $@ #
#### $*   #
   #  #####
   ####
