#### #####
#  ###   ##
# $  $*...#
#  $**+$  #
#     #####
#    ##
######
