#####
# @ #####
# $$#.. #
##      #
#. $#..##
##$ #$ ##
 #  #   #
 #  #   #
 ########
