
    ###
#####.#
#  ##.#
#   $ #
#  $# #
###  @#
  #####
