#########
#@*.... #
# $  *# ##
#### .#$ #
 ##    $ #
 # $#$   #
 #      ##
 ###   ##
   #####
