###########
#    @    #
# $#*#.#$ #
#  * ..*  #
# $# # #$ #
#  *.. *  #
# $#.#*#$ #
#         #
###########

