
  #####
###  .#
#@$..*#
##$$* #
#     #
#    ##
######
