
 ###
 #+#
 #*####
##    #
#  $# #
# #   #
# ### #
#     #
#######
