###
#.########
# ... #@ #
#  #  $$$#
##  #  $ #
 #. .#  .#
## #  $  #
#   $$ ###
#   #  #
########
