     #####
    ##  @#
   ##   $#
  ##     #
 ##     $#
 # . ##  ##
##   .#   #
#.  # $   #
########  #
       ####
