
#######
#.#   #
#.   .#
#   $ #
####$$#
   #@ #
   ####
