   #######
   #     #
   # $$$ #
  #    $ #
 # *   $ #
# *@* #$ #
# .*. #  #
# . . ####
 #. .#
  # #
   #
