#######
#     #
#  .@.#
##    ####
### .  #.#
#   ##   ###
#    .  $  #
##.#   $$  #
 #  # $$ $##
 ##       #
  #########
