########
#   #  ##
#   $   #
##  $   #
 #$ ##  #
 #  #####
 #*$ @ .#
 #   ...#
 ########
