
#####
#   ###
#. .$@#
#.**$##
##  $ #
 #    #
 ######
