######
#.#  ####
#....   ##
# # ##   #
# # $    #
# ##$$ $ #
#  $ #####
#  #@#
######
