  ######
  #  ..#
  # $ ##  #####
  ###.#####   #
   #   ##     #
####  $## #*###
#@*  $$.    #
#$$  .##   ##
#. #########
####
