  #########
###@ .....#
#  $$## # #
#   $   # #
## $  $## #
 #####    #
     ###  #
       ####

