
  ####
###  #
#    ##
# $ $ #
#  #$@#
#... ##
######
