
######
# .. ##
# .#$ #
# @$  #
#   $ #
####  #
   ####
