#########
####.####
#  * *  #
#  ...  #
###.#.###
#  .#.  #
#   #   #
# $###$ #
#   $   #
#  $#$  #
# $ $ $ #
##  @  ##
#########