 #####
 #   ###
 #  $  #
 # ..# #
##$#*..#
#    $$#
#   #@ #
########
