
 #### ######
 #  ###    #
##         #
# *$####  ##
# .@# #   #
##### #   #
      #####
