
  #####
### . #
# $$* #
# $ . #
# @$* #
# $...#
#######
