    #####
   ## ..##
   # *.$ #
  ##     #
###  $$ ##
#.    ###
###*$##
  #  #
  #@ #
  ####
