####
#  ##
# $ ##
#   .#
##$ $#
 #   ##
 ## $@#
  # .$##
  ##$..#
   #  .#
   ## .#
    ####
