   #######
   #     #
   #  $$ #
  #  $ $ #
 # * $   #
# *@* #$ #
# .*. #  #
# . . ####
 #. .#
  # #
   #