
#######
#.    #
#*#   #
#.$ $ #
#.*$$ #
#.#@  #
#######
