
 #####
 #@..#
##$*$#
#    #
#    #
######
