
 ###
 #.#######
 #.#     #
##+  ### #
# * $### #
# #  $   #
#   $#####
#    #
######
