 ########
 #   #  #
 # *  * #
#  . *   #
# $.*@$$ #
#  . *   #
 # *  * #
 #   #  #
  ######