
  ######
  #@ #.#
####$ .#
#  #  .#
#  $ $ #
#     ##
#  ####
####
