
 ######
 #  #.#
 #@ #.#
##$   #
#  $  #
#   ###
#####
