  ####
  #  #
  #  #
  #$ #
 ## $##
 #  $ #
 #... #
##$ ###
# . #
#  @#
#####
