##############
#   #   #    #
# # #$$ #  @ #
# # # $ #  #.#
# $     #. . #
# # #$$ #  #.#
# # #   #  . #
# # ###### ###
#            #
########## # #
         #   #
         #####
