 ####
 #  ########
##..  .  $ #
# $ $ $ $@ #
# . ######.#
#####    ###
