        ####
  #######  #
###  ## $  #
#   . # $  #
#     #  $##
#### ## $$ #
#### #   $ #
#        #@#
#.  ..######
#.#####
#.#
###
