
#######
#  .  #
# ..$ #
## $  #
 ###$ #
   #@##
   ###
