   #####
   #. +#
#####$*#
#.   . #
## $$  #
 ### ###
  #. $ #
  #    #
  # $  #
  ###  #
    ####
