  #####
 ## @ #
 # $#.#
##  $ #
# $ # #
# ..  #
#######
