#############
#           #
#  ... ...  #
#  *$$ $.$  #
# $*+$ $*$$ #
#  *$$ $.$  #
#  ...  .   #
#           #
#############