   ####
   #  #
 ###  #
##   $#####
#..  .##  #
#   $   $#@#
####  ## ##
   ##*#   #
    #     #
    #######
