 #############
 # ##     ## #
#  $.$.$.$.$  #
 #  $.#+#.$  #
 #   *.$.*   #
  ##  $.$  ##
   ##     ##
     #####