##########
# $     .#
# $ $   ##
#  $  ####
#  $$#  .#
###. $$.##
  #  #  .##
  #### .+.#
     ######
