#########
#       #
# $ $ $ #
# ### $ #
# $.$ # #
# .*. $ #
# #*# ###
#.$.$.#
#. + .#
#######
