
####
#  #
#  ###
#  $ #
#  *.#
#@*  #
#  ###
####
