
######
#..  #
#.   ###
### $  #
  #$$  #
  #@ ###
  ####
