
 ####
##. ##
#..  #
#    ###
###    ##
  #  #  ##
  ## $$$ #
   #   @ #
   #######
