       ########
########..    #
#      ###@## #
# $$$$  .. .. #
#      ### ####
# $$$$ #      #
#      # .  . #
# $$$$ # .... #
#      #      #
###############
