###
#.#########
#    .#...#
# $ ###. ##
##  #    #
# $$#  $ #
# $   $###
# @# $. #
#####   #
    #####
