  #####
  #   ###
###   $ #
#  # $ .#
# $##$$@#
#..   $###
#####. . #
    #  $ #
    ## ..#
     #####
