
    #########
    #       #
##### ##### ##
#   # #   #  #
# #$  # # ## #
#   ### $   @#
### # ## ###.#
 ## ####   #.#
 # $    $# #.#
 # # ###   #.#
 #   # #######
 #####
