#########
#..##   #
# ..$$ $##
#     .$ #
#####$.$@#
    #  ###
    ####
