     ###
  ####.#
  #..$ #
  # $$ #
  #.$  #
  # #$.#
###   ##
# *$*###
#. . $@#
########
