#########
#   #   #
# $    $#
#  $ #  #
#  # * .#
####$$*##
  #...+#
  ######
