###
#.####
#.##.####
#+$ .# .#
# $* #$ #
### #   #
 #  $  $#
 # .#$$ #
 ##     #
  #     #
  #######
