 #######
 #.+$ .#
 ##$$$###
 ## #   #
##  *   #
#.  .####
###$  #
  #   #
  #   #
  #####
