#########
#  . .$.###
# ##$.  $@#
#  # $  ###
#     ###
#    ##
######
