
  #####
###   #
#  $$@#
#   $##
#.   #
#.. ##
#####
