   ####
   #  ###
  ##  * ##
  #   $.@#
 ##*$#.. #
##    ##.#
# $$    ##
#     * #
#########
