#####
#.. ####
# .$   #
##  $  #
 ###@$ #
   ##  #
    ####

