 #############
 #...# @ #...#
 #.  # # #  .#
 #           #
 #  ## # ##  #
###### # ######
#   #  #  #   #
# $    #    $ #
# $$#$ # $#$$ #
#   #     #   #
###############
