#########
#       #
# $..$# #
# #.$.$ #
# $..$@ #
# #.$.$ #
# $..$# #
#       #
#########
