 ######
 # .. #
 # *@$###
 ##$#   #
  # *   #
  # $####
  #.  #
  #   #
###$  #
#.    #
#######
