####
# @#
#  ######
#  #  #.#
# $#$ * #
# $.. . #
# $## . #
#   ##$##
#     $.#
#########
