    #######
    #.    #
   ##$#   #
#### .## ##
#   $     #
#..   ##  #
##   $##  #
 ###$ #####
   #@ #
   ####
