#######
#     #
# $ $ #
#...# #
#.#$$ #
# * @##
#  ###
####
