   #########
   ###   ###
   # $   $ #
#### . @ . ####
# # #$.#.$# # #
# $    .    $ #
#   #$.#.$#   #
#### . $ . ####
    #  #  #
    #######