######
# .  #
#.$# ##
#*$ $ ####
#@* .  ..#
# ## $ ###
#  $ # #
### *$.#
  ##   #
   #####
