    ####
  ###  ###
  #  @   #
  #$#.$. #
### $  ###
# . .#$#
#      #
###  ###
  ####
