 #####
 #   #
 # $ ######
## #  $   #
#  ...$#$ #
#  @..    #
## # ######
 # $ #
 #   #
 #####
