  #####
  # . #
  # .$##
  #$.  #
  # .  #
  #$.###
### .#
#@$$ ##
# $   #
###   #
  #####
