
 ######
 # ...#
 #$#  #
##  @ #
# $$  #
#    ##
######
