 #######
##   @ ##
#   .*  ##
# $*$ *  #
#  #.*#$ #
## .$ . ##
 ##    ##
  ######
