
#####
# ..###
# . $ #
#  #$ #
#@$   #
###   #
  #####
