
#######
#  ##@##
#    $ #
#   $..#
#### #.#
  #  $ #
  #   ##
  #####
