###########
#  . $ .  #
# # $.$ # #
#  $.@.$  #
# # $.$ # #
#  . $ .  #
###########