
 ######
 #   .#
## $  #
#@$ # #
# $ #.#
###  .#
  #####
