
#######
#     #
#.# # #
# $$. #
#.  ###
# #$#
#  @#
#####
