    #######
#####  .  #
#   $@.## #
#   ## ## #
##  #     #
 ### $. # #
  #   $   #
  #  ##   #
  #  ######
  ####
