     ####
     #  #
     #  #
     #  #
     ## #
  ##### #
 ##  #  ####
 #   #$ ...#
##    $ ####
# $$ #*$####
#    #@  ..#
############
