##############
#   #   #    #
# # #$$ #  + #
# # # $ #  #.#
# $     #. . #
# # #$$ #  #.#
# # #   #  . #
# # ###### ###
#            #
########## # #
         #   #
         #####
