##############
###    #    ##
##  #$ # $#  #
#  #       # #
#   $ . . $  #
#  ##.#.@.## #
#     . .    #
#  #   .  #  #
##  #$ #$#   #
## $   #   $ #
####       ###
##############