
#####
#.  ###
#.#$  #
#.@$  #
#  $ ##
###  #
  ####
